ENSG00000272398
ENSG00000135439
ENSG00000130348
ENSG00000198719
ENSG00000169429
ENSG00000171608
ENSG00000164494
ENSG00000198732
ENSG00000130349
ENSG00000173404
ENSG00000142549
ENSG00000146426
ENSG00000130347
ENSG00000275385
ENSG00000178409
ENSG00000134363
ENSG00000137142
ENSG00000133063
ENSG00000150275
ENSG00000124440
ENSG00000124102
ENSG00000158164
ENSG00000203710
ENSG00000253305
ENSG00000169840
ENSG00000170549
ENSG00000153132
ENSG00000111087
ENSG00000197083
ENSG00000128573
ENSG00000188011
ENSG00000168505
ENSG00000164946
ENSG00000231789
ENSG00000257335
ENSG00000258548
ENSG00000162992
ENSG00000085552
ENSG00000153993
ENSG00000108342
ENSG00000263958
ENSG00000253953
ENSG00000249158
ENSG00000241945
ENSG00000214456
ENSG00000206557
ENSG00000181374
ENSG00000120057
ENSG00000237125
ENSG00000125813
ENSG00000170166
ENSG00000175189
ENSG00000150244
ENSG00000249362
ENSG00000143869
ENSG00000169297
ENSG00000215612
ENSG00000204963
ENSG00000108688
ENSG00000198028
ENSG00000273100
ENSG00000186493
ENSG00000230699
ENSG00000081842
ENSG00000287200
ENSG00000234354
ENSG00000170561
ENSG00000287893
ENSG00000260577
ENSG00000163736
ENSG00000271551
ENSG00000204791
ENSG00000286478
ENSG00000179873
ENSG00000257443
ENSG00000196109
ENSG00000237863
ENSG00000229676
ENSG00000246528
ENSG00000148346
ENSG00000223528
ENSG00000180458
ENSG00000166926
ENSG00000136944
ENSG00000118113
ENSG00000261754
ENSG00000229654
ENSG00000131355
ENSG00000185275
ENSG00000171956
ENSG00000183032
ENSG00000197472
ENSG00000133124
ENSG00000237210
ENSG00000287340
ENSG00000288041
ENSG00000174450
ENSG00000261711
ENSG00000236816
ENSG00000162892
ENSG00000287209
ENSG00000271234
ENSG00000204936
ENSG00000174697
ENSG00000129514
ENSG00000187185
ENSG00000124557
ENSG00000184895
ENSG00000264956
ENSG00000236054
ENSG00000285534
ENSG00000262539
ENSG00000178919
ENSG00000287867
ENSG00000230635
ENSG00000269345
ENSG00000228304
ENSG00000271776
ENSG00000283458
ENSG00000205215
ENSG00000205266
ENSG00000279104
ENSG00000277984
